ILGDTY HDF QTWDGGAL	GYIFTGYY INPNTGVT AKDRAWLVYDDGSDV	1
QGIRDD AAS LQYNSYPRT	GFTFSSYT ISSSSAYI ARDGTSLTVAGPLDY	0
KLGDKF LDS QAWDSITNWV	GFTVNSNY IYSGGST ARVLYVCGGDCSFTFDY	0
QSISSY DAS QHRSTWPPN	GGTFSSRA IIPIFNTP AREMATIFGRMDV	5
ESLLHSDGKTY EVS MQTIQLPGT	GGIMRRNG IIAIFGTP VASSGYHLHRETWGY	4
QDIKNY HVS HQCYNLPYT	GFIFGHFA ISGGGLNT ARFDSSGYNYVRGMVV	6
RSLVYIDGNTY KVS MQGTHWPT	GGSFSGYY INHSGST ARGRAGILTGYSYDY	6
QSVPSSY GAS QQYGSSLT	GFTFSTYG MSWDGSQK AKDWGPRILYYFTSGSYSPLDY	6
QSIGTY TAS QQSYNNPYS	GGSISGHY IYYSGRT ARDSTGYSKENAFDI	5
QSVLYSSNNKNY WAS QQYFSTPLT	GYTFTGYY INPNSGDT AKDTTHTDCSDGGCYWENFDC	4
QDINNN DAS QQYRNPLLT	GFTLGHFA ISGGGGTT GKYDSSGHHYVRRMHF	6
QSVSSN GAS QHYNNWLWT	GGTFSSFA IIPILGIT ARDSHTALGGMDV	5
QDIKKY DAS QRYDNLLPILT	GGPFINFA IMLIFGPE VRFKGLEYRSWGAATEDPFDI	4
QGISSW AAS QQANSFLGLT	GFTFSNYG LSASGGST AKDEGRPSASLGIMYYFDY	5
QSVLYSSNNKNY WAS QQYFSTPLT	GYTFTGYY INPNSGDT AKDTTHTDCTDGGCYWENFDC	0
QNVSSTY GAS QLXXH	GYSISSGSY VYRSGNT ARPSLSYRIYFDS	6
QSVSSN GAS QQYYNWPPLT	GFTFNTYN ISSSSLSR ARGAQAGYSSFFPPTTF	6
QDINNN DAS QQYREPLLT	GFTFGAFA ISGGGGST GKYDSSGHHYVRRMHF	4
QDINNN AAS QQYRTPLLT	GFTFHQFA INADGAIT GKYDSSGHHYVRRMHF	6
QSISTD EAS QQYNIYSWT	GYTFTNHD VNPSNNNV ARGLGGGISVFGVLVRGRWFDP	6
QSISSN GAS QQYNNWPPLT	GFTSGTYA VTGTSDTT AKHGHMIFGVIIPNWFDP	6
QSIRSY TAS QQSYDFPQT	GFTFGDAY ISSGRGYA VRDRTGSRDINAFDI	2
QAINNY GAS QQYDSYPHT	GGPFFSTYG LIPIFKTT ARGGDYSSRWKQEET	5
QNIGTY VTS QQSYITPWT	GFTFSRSS IKEDGGEK ARDFQERLLDTLTGCYDY	2
QSINNW KAS QQCDSYSVA	GGSFSSFG IIPIFGTS ARRRDELGDYGTIYFDH	5
QSVSSS GAS HQYRRWPDT    GFIFNRYT ISPSGNYI ARGQLLDFDRVSTINEN	3
QGISSW KAS QQYNGYPYT	GVIFSNYA IIPLFGST TKGEGVYQPLLST	6
QSINDY DAS QQRSNWPPGVT	GFSFGDFY ISPSGGTI ARAGVAVLTFDNRGWRFFDP	4
QSVQHSNGYNY VGS LQTLHTPFT	GFTFSYAS IKGDNGGGAT TTNANTDYYDTHGLSNY	2
QSISRW RAS QQYNYAGST	GGTFSTYG IIPLFGTA ARVLPEGEFDY	6
QNIRTY HAT QQSYDWPYT	GDSITNYY ISYSGHASGRT AREITRGLDAYDI	0
QNVQHSNGYNY LGS MQALQTRT	GFPISIGW MKSDNGGGAT SSTADRDYYDTAGFLDF	2
QSVGTY DAS QHRAT	GDDFTSGGFY IHYAWSP ARGIVRLPANIPLANDY	6
SSDVGAYNL DVT SSYTNTRTLL	GFIFGTFG ISSASASI ARDGGVPRRYSLDV	6
NIGSKS DGS QVWDSSSERHVV	GFIFSSYW INQGGSEK VRVGAYGDTYHDYYGMDV	0
SSDVGNYNF EDN 	GFTFTRHW VKQDGSDK ARYGGSYLDY	6
QDVSTW TAS QQANSFPLTX	GFTFGDYA IRSKRYGGTT TRDLVGATTFFLYGMDV	5
QSVRGNS GAS QQYGSSPQT	GGSVSSWTYY IYNRKTT ATQGI	6
ESVSSH DAS QQYNNWPS	GFTFDDYA ISWNSGAI TKSYGSGSYSDS	1
QSVRSY DAS QQRSNWPPEFT	GGPFMSYT IIPILGTA ARDYGSGSSQTSGAFDF	6
QSVSSY DAS QQRSNWPPWT	GGSISSYY IYHSGST ARGGGHYFLNWFDP	6
QGINIY GAS QKYDSAPFT	AFTFSSYT ISAGGGST AKLSTYSNGNF	6
QSXSSSY GAS QQYGSSPIT	GGTFRSFA ITAIFGTT ARHIEYGPKSLVDY	6
QSVSSSY GAS QQYGSSPYT	GGTFSSYA IIPIFGTP ARDTYYSDRFYYYAMDV	4
QSIRSW RAS QQYYGYPWT	GFSFSTFA VSDSGGIT VKEEKRFLDKLSIMA	6
ETITDW RAS QQYSSYSWT	GYTFTRYY INPGGGRT ARDPRFQGLYDGSDYYWGHY	6
QSVSSN GAS QQCDNWPPT	GFTFSNYA ISGNGGNT VKGQFLEWYNWFDP	1
NIGSQS CDR QVWDGSSEHHV  GFTFSTYH ITSSSGTI ARDSFRQGSMDV	6
TGAVTSGYY STS LLQYGGAWV	GFTFRSYG ISYDESKK AKGVHCGSSSCYPVQFYYGVDV	1
QDIGDY DAS QQYNNLTS	GFTFRSHW IKHDGSER ARGSGAD	0
QSISTW KAS QQYNSFSRT	GFTFSSYA ISGSGGGT AKEGDVDIVVTITPPRYY	6
QSISSW KAS QQYDSYPWT	GGTFSSYA IISIFATT ARAGNTQWLRYPLDS	6
QSVSSS GAS QQYNNWPPVT	GFTFGSYA ITGSGIST AKAAAPHIVVAGVFDY	6
QSIRNY AVS QQSYSTLPYT	GGSIRSGIHY IHYSENT ARAAKESLCIGGSCDSNYEHYGLDV	0
QSVGSY DAS QQRSNWPPLT	GFTFTSYA ISTSGGSR AKEMRRDIATAGYFDY	6
QSISNY AVS QQSYSTLPYT	GGSIRSGGYY IHYSDNT ARASKESLCIGGSCDSNYQHYGLDV	0
QDISNY DAS QQYDT	GFIFSDYY ITPSSSYT ARTENSGYDLVRV	0
QSVSSF DAS QQRSNWPPIT	GFTFSNYV ISGSGLST AKDVVATNPPLSGYFDY	6
QDIRIH DAS QHYHNLPRT	GFTFSSFA ISAGGGNT AKSDSSGFQYGRREF	1
ESVGNK NAS QQRGTWPRGLIT	GYRFTRYG ISAYSGDT ARDHVQGEVSIYYYAMDV	6
QSVSSN GAS QQYDNWPPIT	GFSFSSYS ISSYSGTI ARDDDSNDYNQDRYYYYGMDV	0
QSVSNN GAS QQYNNWPRT	GFTFPGYN ISSSSSYI ARDLGGRGALTGYWIDS	5
QNINNN AAS QQSFTTLGST	GDSISSGIYF VFKTGTT ARETPADRPYCGSGSCSFDS	6
QIIANNY DAF QDYGSSLIT	GDTFSYYA ITPLFGTS ARGPTYGSDRTFYQGMDV	1
QNIRSY AAS QQSYSTPVT	GYTLSNFG ISAYTANT ARIEGAANYYYMDV	4
NLGDKF QDI QTWDSSTVXXX	GGSISPHY IYYAGST ARGGFPAELPPPLDP	0
QTISNY AAS QQSYSIPWT	GFTFSDSY ITSSDSPISE ARIADYGDHVPVFDY	6
QSLSNSY GAS QQYGSSRHT	GYSFTSSW LNPSDSYP TRDSFYDVDLSSFYMDV	4
QRISNY NAY QQSYITLFT	GFTFSSYS INKEGSEK ARVSREEWATVDDPHDYYYMDV	0
QSISVY GAS QRSYITPFT	GFTFSSYA MSGRGDTM AREEFTDTEMTITQGDFGY	1
QRISNY NAY QQSYNSLFT	GFTFSSFS IKREVSET ARVSREDWATVDDPHDYYYMDV	3
QRISNY NSY QQSYNSLFT	GFTFRSFS IKREVSET ARVSREDWATVDDPHDYYYMDV	3
QRISNY TAY QQNYNILFT	GFTFSSYS INKDGSEK ARVSSEEWATVDDPHDYYYMDV	5
QRISNY NAY QQSYNTLFT	GFTFSSFS IKREVSEK ARVSREDWATVDEPHDYYYMDV	3
QDFSNY DAS 	GFTFSDLY INPNSGTT ARDIDHGDYRAADVFHI	0
QDFSNF DAS 	GFTFTDVY INPNSGTT ARDIDFGDYRAADVFHI	3
QDFSNY DAS 	GFTFKGIY INPNSGII ARDIDSGDYRAADVFHM	1
QRISNY TAY QQSYNSLFT	GFTFSSYS IKKEGSEK ARVSREDWATVDEPHDYYYMDV	1
QRISNY TAY QQNYNTLFT	GFTFSTHS IEKEGSEK ARVSREEWATVDDPHDYYYMDV	0
QRISNY TAY QQNYNTLFT	GFTFSSYS INKDGTEK ARVSSEEWATVDDPHDYFYMDV	0
QDFSNY DAS QQLAT	GFRFSELY INPTRGST ARDIDSADYRAADVFQI	1
QDFSNY DTS QQLNT	GYIFSGSY INPKTGNT ARDFDYGDYRGSAFDI	0
QDFSNY DAS 	GFTLNNLY INPNSGIT ARDIDTGDYRGADVLQM	0
QRISNY TAY QQSYNTLFT	GFTFSSYS IEKHGGEK ARVSREEWATVDDPHDYYYMDV	0
QDFSNY DAS 	GFTFKGIY INPNSGII ARDIDSGDYRAADVFHM	2
QRISNY NAN QQSYNSLFT	GFTFSSYS INKEGSEN ARVSREEWATVDDPHDYYYMDV	0
QSISVY GAS QRSFITPFT	GFIFRSYA ISGSSEDT AREEFTDTEMTINQGDFAY	3
QDFSNY DTS QQLNT	GYVFSDSY INPKTGGT ARDFDYGDYRGSAFDI	0
QDFSNY DTS QQLNT	GYIFSGSY INPKTGGT ARDFDYGDYRGSAFDI	0
QDFSNY DAS QQLTT	GFTFTDCF INPSRGTT ARDIDSGDYRAADVFQI	0
QDFSNY DAS 	GFRFSDLY INPTRGTT ARDIDSGDYRAADVFQI	1
QDFSNY DAS QQLTT	GFTFTDCF INPSRGTT ARDIDSGDYRAADVFQI	1
QRISNY NAY QQSYNSLFT	GFTFSSYS MNKEGGEK ARVSREEWATVDDPHDYYYMDV	1
QSLSXSY GAS HQYGSSTGT	GYTFTSYA ISTYNGNS AREGYDHLWGTYRFEAIDYYYTDV	1
QDFSNF DAS 	GFSFSDTY LNPKRGTT ARDIDFGDYRAADVFHI	1
QSVSSN DAS QQYNSWPPMYT	GGSISNNIYY IYYSGNI ARHRVGTGPEVGDWFDP	4
QSVGSY DAS QQRSNWPPVT	GFIFNDYA ISWNSDSI YGSGAYQAH	0
NSDIGNNA TNN AAWDDSQMGV	GFTFSSHA ISGDGGST AKEWGWQVSPYGVFDV	1
QSISNR QAS QQYNTNSRT	GFSFSNYG ISHAGAYK ATLGGDIVVVSAERSGYYYGLDV	2
RGLLYIDGNTY NVS MQGTYWPFT	GYTFSNYG ISAYNGHT ARDRRDLLTGSLGDY	6
QDISNY DAS 	GFTFSSSW INSAGSSK ARDHDYGDYRGNAFDM	5
QDVSNY DTS QQVXXXH	GYSFTTYG ISTYNGYT ARRGDYGDYRGDAFDI	4
QSVLYGSNNKNY WAS QQHYRIPQT	GFIFSDYT ISSYSGYI AKDRVRDGDNDWDSVDATYWGYGVFDT	5
QDMSNY DTS 	GFSFSSFW INNDGTFT VRDNDYGDYRGNAFDI	5
QSVLYSSNNKNY WAS QQHFTTPQT	GFTFSDYT ISSRSGYI ARDRVRDGDNYWDSVDATYWGYGAFDI	5
QGIGND DAS LQHNDYPLT	GGSISKYY VHYAFYIGAT VRADGDSEGFGYHYGMDV	5
QGISSA DAS QQFHSYPLFT	GVIFSNYA ILPIFGTA ARAARLYQQAYDI	5
QDISNY DSS 	GFTFSSSW INSAGTSK ARDHDYGDYRGNAFDL	5
SSNVGSHP SDR AAWDDSLDGVV	GFTFSSYG ISYDGYNK AKIFSWQQLDYYYYAMDV	6
QDISNY DTS 	GFTFSSSW INSGGNFK ARDHDYGDYRGNAYDI	5
SSNIGSNT SNI AAWDDSLNGXXC	GDSITCSSCY MYYSGRT ARLFGELVGYQAFDV	4
SGXSSSP VNXDGSH QTWGTDXQV	GGSMRSSSYY MYYSGST ARRWFGELDYYGSDV	6
NIGSKS YNR QVWDRNIDPH	GGSMRSYY VYYSGGT ARGVSALVSVDYYYYYMDV	3
NIGSKS HNN QVWDRNNDPL	GGSISTYY VYYTGGT ARAVSTLVSVDYYFYYIDV	5
NIGSKS YNR QVWDRNIDPH	GGSIRSYY VYYTGGT ARGVSALVSVDYYYYYMDV	5
QDVSNY DSS 	GFTFSSSW INSGGTMK ARDYDYGDYRGNAFDL	5
NIGTKS YNN QVWDRNNDPL	GGSIRSYY VYYTGGT ARGVSALVSVDYYYYYMDV	3
NIGTKS YNN QVWDRNNDPL	GGSIRSYY VYYTGGT ARGVSALVSVDYYYYYMDV	2
ESVSVS KAS QEYHTSSRVT	GFTFISYA ISGSGGAR AKDRILPYDTDAFDI	5
QSVNSD GAS QQYNNWPPLT	GFSFKDYA ISGSGLST AKDRVVGRPWEYSLDF	4
QSLVHSDGNTY KVS MQGTHWPT	GFSVSSNF LYSGGAT ASRHYNYDDDY	5
QSISFS QTS QHYSNYSYT	EYTFRNYW INQDGSEK ARAGSYGDYRPINNWFDP	6
ESVSTY DAS QQRSNWPPIT	GFTFRIYA ISNEGTNK ARDPSNPPHWGNFDS	6
QSVNNY DAS QQRSNWPPIT	AFTFNKYA ISGSGLST AKDLAVTPPAQGYLDR	6
QSLVHTDYKVY KVS MQGRFWPT	GDSNTRTY IVQGGGT AATFHDFEIGFRWFDP	5
QSIGSW KAS QQHNSYSGA	GGSITSNTYY ISFSGRT ARQLTGMVYAILLPSYFDF	6
QRLTSS AAS QYRSHWPPAVT	GGSISSYY IYYSGST ARDCSGFEDMDSFYYFMDV	6
QSVLYTSNNKNY WAS QQYYSNSMYT	GGTFNTYI INPSFGSV ASPAYNSGFALLH	6
QSIDNW KAS QHYDTYSGT	GGSFTSFV VIPIFATP ASPDLTMVFVPHTGPLDF	5
QSVSSN GAS QQYNNWPKT	GFTFSTYG IWYDGSNK ARDSEGSGWYFDY	0
QDITNF DAS QQYDDLPYT	GFTFNIYA ISSRGDYI ARAGLGTVDLRWGGAFDH	0
QSISIS AAS QQSYSTPIT	GFTFSSYA ISSNGGST VNGGRAFGVVIKYYYYGMDV	6
QGIRNY AAS QKYNSVPLT	GDSINSGGYY IYFTGRT ARDRHDYGEDPFDI	0
QSLVHSDGNTY KIS MQATQFPSIT	GYSISSGYY IYYSGST ARGRGATVTTHFDY	1
EGISSH GAS QQYNNWPH	GFTFDDYA ISWDSGAI ARSNGAGSYSES	0
QSISDW KAS QHYNTYSGT	GGTSNNYP SIPIFNTP ATSAGGIVNYFLLFDI	5
QTITTW KTS QQYSTYSGT	GMTSNSLA IIPVFETP ATSAGGIVNYYLSFNI	5
QSVTNN GAS QHYNRWPLGFT	GGSVNSGGYY IYNSGSV ARVNIYLVTVEEYHYGMDV	4
QGISSY AAS 	GYSFTSYW IHPGDSDT ARPKYSSSSYSGFDV	0
QTISTW DAS QQYNNYSG	GYTFTTYS INTYTGNP ATRGPVVLGEALAY	1
QSVSSY DAS QQRRNTX	GASISSTNW IYHNGST ARERNRVYYYGMDV	1
QSISNNY GAF QQYGSSPRT	GVSISMINW IYHNGST VAVAFRAYALFDD	1
QTIISW DAS QQYNSYSG	GYTFTSYA INTYTGNP ATRGPLVLGEALDS	2
QSVRFY DAS QQRINWPLT	GLNFISYA VSGTGGTT AKHVTGYYLSGGEGGGGTLDV	5
QSVTGGF GPS QQYGSSPTT	GFTFSDYQ ITSTGNAK VRDLVWVQLPDY	1
QNINTW DAS QQYHSHSKLT	GFTFSNFG ISYDGSNT AKAGLQRFSPHFMDV	2
QSLLHSSGYNY LGS MQALQTPLT	GFTFNIDA IIPSGTYT AREPYNDGYFES	6
QSVSSY DAS QQRSNWLTXX	GGSFGGYY INHSGST ARGRGGYATYYYYYYVDV	6
QNVLYNSNNKNY WAS QQYYTTPPT	GFRFSDHY IRNKANSFIT TRDFLEWSRPYYYHFMDV	5
QSVSSN AAS QQYNNWPRT	GGTFRNFA IIAIFGTA ASSSGSYYGDYFDY	5
QRVSNNF GVS QYYVSSPRRFT	GGTFGSYG ITPIDGIP ARDGGWLRTLDS	5
QILLHGNGNNY LGS MQSLQTPPT	GATFSSLG PIPLSGTP ARKDAGSAYKSFDV	6
QSVSSNY GAS QQYGTSPRT	GGIFRSNA IIAVFGTA ARGPYYYGNSHLDF	6
RGIADY AAS QVYISAPYT	GDTLTSFG INGYNSNP ARGASSTGTMGLRGKNDAFDI	1
QTIKKY TAS QQSYDTPQT	GDSIRNYY IYYSGRA ARDRTGAGDKNAFDV	1
QTVSGSF GAS QQYGRSPT	GYSFNTYW IYPGDSDT ARLGCGTTDCSPTWPYYYYGLDV	1
QTVSSTF GAS QQYGRSPRT	GFYFSDYG IASSGSNI ARSPGIAVGLIDY	1
QSVLYPSNSRNY WAS QQYVTSPRT	GFTFTSFG ISGSDGST AKGLAYCSFGSCPYPLDY	1
QSVSSY DAS QQSSNWVT	GGTFSTYT IYPVFGSA ARGRTSGSQDRLPLLWGLSGFDI	5
QTITSY AAS QQSWS	GFTFINHA ISGTGDST VKAAKRSYYYYYYMDV	5
QSSTYY AAS QQSWTX	GLTFSSYA ISGTGEST AKSATRSYYHYYYMDI	1
QSSTYY AAS QQSWTX	GFTFSSHA ISGTGDSS ARSATRSYYHYYYMDV	0
GSNIGADYD ANT QSYDRSLSGYVV	GGSISSYY VYYSVDFTGST ARHILYNPAYSSGWTPGFDP	6
QTVNSDF STS QQYGRSPSIT	RSSISGHY IYSDGTT ARDFRERLGHRWEQAFDY	4
QSISSS IAS QQSYSTPWT	GTSITTHY ISSDGTT ARDFRERLGHRWEQAFDF	5
QSLVYSDGNSL KVS MQGTHWPFT	EFTFSDYY ISNSGATI ARMPRVADI	1
SGSITSNY EDN QSYESRNKRV	GGTFSTYA IIPRLGRT AREGAIDDPQAGYHYYNGIDV	5
 RVS QQSYSSPWT	GFTFRDFA ITASGXER AKDRGSGTYENWFNP	0
QSVLYSSNNKNY WAS QQYYSTPRT	GFTFSSYG IWYDGSNK ARAAWSRIAVATGAFDI	5
QSISSY AAS 	GGSISSSNYY IYYSGST ARHSAYGSSWVRGVVFDM	0
ESISSH GAS LQYNNWPM	GFTFDDYA ISWNSGSM VTANGAGSYSVY	0
QDIGNW RTS QQPDSFPLT	GFSIGDYT IRTNAYGGTT SRMYFYDSGGPRQFYYGMDV	1
KSVNSY VVS QQTDTVPYT	GFTFDNFA INKSGNRR AKDRTDYIGSYVHDYFDY	1
SSNIATNP RNN AAWDDSLTGNWV	GASISSSRHY IYYSGST ARLVLIPVVGERNIRYFDY	1
SSNIGTHY SDN AAWDDSLSGRDVV	GDSIRSITYY VYYSGNS ARPPREGPAFDP	2
QTLGNY GAS QQTFRSLET	GGSIISDY FAPGGSS ARSQWLDVDLSDFYFDF	3
QDIIRW SAS QQPDSFPLT	AFTFADYT IRTNAYGGTT TRFSFYDSGGPRQFYYGLDV	3
SSNIGADYD GTR QSYDSSLSGSV	GFIFSNYW INSDGSST TRGSGWSYNAFDI	2
QSVSSY DAS QQRGNWLWT	GYTFTGYY INPNSGGT ARDDYPDYEVY	0
SSNIGADYD GTR QSYDSSLSGSV	SGSISSGDSY IYSNGNA ARGVDYDILTRFSFGFDF	6
QSVSSFY GTS QQYDTSLT	GFTITPYT ILYDGSST ARGYGSGKSHYYFDY	0
 DVT YSYATSSTXXXV	GYTFSAYY INPDSGAT ARIFRFSSGLDY	2
QNISRY DTS QQNYHPPPT	GGSITNYC IFYNGKT ARESSGYTQKNAYDY	0
HDIKNY GAS QQYESLPLT	GFNFRDSA ISASGDRT AKGRYSMSRVVIILDYYYGMHV	0
QDISNY DAS QRYENLPPSLA	GFSFNSYG ISHDGSEK AKERSLGGVWSSGWSNYYYYGMDV	0
QGISNY AAS QKYNSAPLT	GFPLSNAG IKRKTDGGTV TTDLDVVSWWEPPQGENY	0
NIGSKS DDS QVWHRSSDHQVI	GFIFSSNG ISYDGSNK AKSGRGLGYDSSGHYYYYAMDV	0
QSISRN ASS QQSYSTPM	GGSINGYY IYDSGSA ARWFREALFGQDHDAFDI	0
RALAA LHP NRVSISSRSL	GASVSRHH VSYSGST ARWFREVLTADESDAFDI	0
SGSIASNY EDN QSYDGTTWV	GFSVSRKF IYSDGNT ARDYS	2
QSISSW RAS QQYDIFPYT	GFTFDDYA VSWNSYSI AKDLRSQSPYASMDLLEGDGMDV	0
SIGSIS DDS QVWDSSDHYVXXX	GFTFAEYD INWNGAGT ARYRPCGGACYYFDY	0
QGISSY AAS QQLNSYPLT	GFSFSDYY ISRSGSTI ARVEGSLSLETASYYYYGMDV	2
NIGSES DGI QVWDTSGDQVV	GFTFRNAW IKSKSDGGTT TRTYGDYAPYYYAMDV	0
NIGSYS DDS QVWDSSSDQGV	GFTFDDYT FSWDLVTT ARGRYYFDNTGYYPSFDS	0
NIGSSKS NDN QVWDSSSDHVV	GFTFEEYT INWDGESS AKGAYYYDNTGYFPYLDS	6
SSDVGSTTY DVS SSHTSSSTLV	GFTFDAYG ISYDGNNK AKDDGLETYYPFYSYGMDV	0
NIGTKS DDR QLWHNRGI	GFSFHHSG INGNGRTT ATEKGCGGDCYYFNS	1
NIARKS DDA QVWDSSSDHVXX	GFTLDDYT LNWDGDIE AKGAYYSDNTGYYPYFDS	0
QSVSSN GAS QQYNNWPPLT	GFTFSSYG ISGSGIST AKGRRGPFEDGWFDT	0
RSNIGSDY RDS AAWDDNLSGLL	GFTFSTYA ISYDGSHQ AKDSGYTINWAPGY	0
EGIRID AAS LQHDSYPRT	GFTFSDFE ISRGGYNK VRDHVELATDHSEFDY	0
NIGIES DDG QVWHRYSDHMI	GFTFGSYG ISYDGSEK ARVFQSYGMDV	0
EGIRND AAA LQHNSYPRT	GFTFSNYE ISRSGYTI ARDHVEMATDHAEFDY	1
SSNIGAGYD GNN QSYDSSLSASVV	GFTFSDHY AGIKPNSYTT TRLAYSSGWYWFDP	0
NIGSIS DDS QVWETGSDHWXX	GFTFDDYD INWDGGRT ARRRSCGGACYYFDY	0
NIGPKS DDS QLWDGGSDNSGV	GYTFTDYD ISPSSGGT ARLRSCGGDCYYFDY	0
QGISNS GGF QQYYSIPLTX	GFTFDDYA ISGDGVDT AKDAGIYSGGWYYFHY	0
QSISNF AIS QQSYSSIT	RGSVSSGSYH INYNGRT ATPDSGYDSGMFHN	0
SSDVGGYNY DVT CSYAGSYTWVXX	GFTFSNYW TKQDGTDA VRDFSDYAATPLDY	0
QTINNN STS QQSYSHFLT	GGSLSGFY VTHTGST ARGPAYDNDASFMYYFDL	0
SSNIGAGYD DNN QSYDSSLSGFYV	DDSISGHY IYYDSGST ARHHSDSGGLPMSFAY	4
SSDVGAYDL EVS CSYADSATRV	GFTFKTYA INAGNGNT ARDTVGATKAFDY	0
RLGDTF RDT QVWDTSASAHV	GFSLSNIIMG ITSKDEK TRIRWDCGGDCYWTHDF	6
QSISNF AIS QQSYSSIT	RGSVSSGSYH INYNGRT ATPDSGYDSGMFHN	0
ALPKQY KDS QSAGNSATWXXX	GFYFSSYW IKEDGSEK AREAGGDYYLDS	0
NIGSKS DDK QVWDSSSDWVX	GFTFSYYW IQGEGNEK ARGYDSTGYNLLGDVFDM	1
SSNIGAGYD GNN QSFDAYLSDSNV	GYSFAAFS IHTDNGNR ARSRGYSAFYYGMDV	6
ELPKQY KDS QSADSRGTFRV	GFVFSTYE IDGSGGTT ARDHHGDYFFDY	0
QSISSW KAS QQYTDYVT	GYSISSGYY MYHSGST ARVRGHGLIGLDFGTIAAPHPFDY	5
QSIGTW KAS QQYNRYPWT	DGSISPYS IDRYGST ARADFDVEGYYGLDV	3
NIGSKS DDR QVWDTSRDHQV	GFTFDYYW IDGDGNKA ARGYDTTGYNSGGDAIFDL	1
ELPKQY KDS QSADSRGTFRV	GFIFSSYE ISGSGSTI ARDSFGDYFFDN	0
QSLVYGDGTTY MVS MQGTHWPYT	GYNFTGHW IDPSDSYI ARLLSGTFDS	4
QSVSTH DAS QQHHNWDVT	GFSFRSYG IWYDGTNI ARELVAVGPIDYFHGMDV	0
SSNIGSNT SNN ATWDDSLDGWXX	GFTFSDYY ISFSFSLT ARALRYCSSNSCPESYYYYYGMDV	0
KLGDKY QDT QAWDRSTHYV	GFTLRPYD ISNDGSDK AKQGYYYDSTGSKWFDP	0
QSIRNW KAS QHYANYLYT	GDSVTSSASY IFYSGDT ARGGLSDFVVPLDS	0
QSVSTY DAS QQRSNWPPIT	GFSFSVYA ISGSGGST AKDRVVPTPLHGYLDS	6
QSVSGY DAF QQRSNWPPIT	GFTFSSYA ISGSGIST AKDYSRTIPLAGFLDQ	0
LSINSN GAS QQYNYWPPWT	GFTFGYYA IRSKAYGATT TRDPLAAGGVLFDY	0
SSDIGGYDY DVS SSYTTSITPHVI	GASFTSGTYY IYYSGST AKNIALFDSYLY	4
SSDVGYYNY EVS SSYGGSNNVI	GGSISSSSHY IYYTGNA VGSQAIDAFDF	6
ALPQQY KDT QSVDITATFG	GYTFADYY MNPNTGGT ARDLGDTTTSDY	5
NIGSKN RDD QVWDASTVV	GFSLSTSGMC IDWNDVH ARMLYGDSVNCLDP	5
QSVSTY DAS QQRSNWPPIT	GFSFSAYA ISSTGIST AKDRVVPTALHGYLDS	5
NSDIGGFDY DVS TSYTSTITXXG	GGSLSSSSYY IYYSGST EGGSGLDAFAI	0
SSNIASNT SND AVWDDSLNAYV	GFTFSSFP ISYDGSNK SRDQGGDYGDYGGGFDY	0
NFENKN YDS QVWDTNSDHFV	GFTFSDFW IKQDGSER ARIPGYHDAFDI	6
NIRVKN RDS QVRDSNTWXX	GFTFSSYG IWFDGSNK AREYYDVLTGPEDYDYGMDV	3
QSLLHRNEDNY FGS MQALQTPFT	GFTFSNYW IDSDGSSP AREPYFPLYFDY	0
QSLLHRNEDNY FGS MQALQTPFT	GFTFSNYW INSDGSRT AREPYFPLYFDY	3
QSISTF SAS QQAYRSSST	GFIFNDFG INWIGSST ARESGDVATAMDYYYYYYLDV	0
SSDVGGYNY EVS SSYAGSNNVXG	GYTFNTYV INVDNANT ARDKGNIVGVPAAWTIGWYGMDV	1
QSVSSD DAS QQYNRRSS	GFTFDDYA ISWNSNWNSGGI AKEGHSDNCLDCDYFYYMDA	0
QSIGNF HAS QQAYRASST	GFIFNDFG INWIGSST ARESGSDVATAMDYYYYYYLDV	0
QNVSNW EAS QQYNSYPRT	GFTFDDYG ISGDGDYT AKDFADYSNSGHFDS	0
QSVGTY DAS QQRSEWPRT	GGSISSPNW IYQSGNT ARDHLVGQQWLEYYYYYGLDV	3
QGISRW AAS QQYNTYPLT	GFTFDEYA ISWSSNSI AKAVEPAAMDIVDYFEY	0
QSISNY SAS QQGYRAPST	GFIFNDYG INWIGSAT ARESGSDVATAMDYYYYYYMDV	0
QSVSSTY GAS QVYGSSPLFA	GFTSSSYE ISKSESII ARLGLLGFGELGPPHWYYAMDV	2
QSFSGW KAS QQYNRFFRT	GFSFSNYD IWYDGSNK AREDNDVEGYYGMDV	0
QSVSSN ITS QQYNYWPYT	QSTFSDYN ITSSSAGT ASRTVTSRAYDI	1
QSINNY SAS QQGYRTPST	GFIFNDYG INWIGSST ARESGSDVATAMDYYYYYYMDV	0
QSISSW KAS QQYYTSFWT	GFSFTTYA ISGSTGRT ARFAYCSGDCYKASYYGLDV	0
QGISNW AAS QQADSFPIT	GGTLSNYA INPIYGTT ATDKLSAFDSYYFYYGMDV	2
QGISRW AAS QQANSFPIT	GGTFANSP INPLFNAP ARDQLSSFDSYYYYYGMDV	5
QAINTW AAS QQANSFPIT	GGTFSNYV INPIYDTI ARDKLSAFDSYYYYYGMDV	2
QRLVYRDGNTY KVS MQGTHWPYS	GYNFTNFW IDPEDSYI ARPGVGPPSDY	5
QSVSYMY GAS QHYGASRYT	GGSISSSSYY IYYTGTT ARPSSDYYSYAMDV	1
SSNIGADYD GNN QSYDSSLGGSV	GFTFEDHA ISWNSGNI AKDIRRGCSGVNCYSYYYYYYGLDV	6
NSNLGADFD GDT QSYDTSLGGSV	GFNFEDHA ISWNRGHI AKDIRRGCDGVNCYSYYYYYYGLDA	0
QSVLNSPNNQDY WAS QQYYSTPFT	GYSFSDYW IDPTDSFS ARIRRDGYNLGLFDH	6
SGSFGTNY END QSFVGSLWL	GFTANSNY IYSDGSI ARDNRREAY	0
SSDXXXYIL EGN CSYAGTSINWV	DGSIRSYY LYYSGST ARVQTIFGVARHYFDY	5
QSISSY TTS LQSYGNVKT	GFTFDDYA ISWDGDSA AKDLNPGHHLGIDY	1
QSVSSS DAS HQRGSWLET	GGTFSTYT IVPILGIT AIRDVRSGYXSSFES	6
NVGTKS DDS QVWDSSGDHP	GGTFSTSS ILPIIGAA ARDSPCGGDCYYFDY	3
AWPKQY KDT QSADISGTNXXG	GFTFSSYW INQDGSEK ARANMDTLSGPYYFYYGMDV	2
QSISNW KAS QQYNTYPYT	GLTFSSYG ISFDGRNK AKDRLWEQWLDPLDS	5
QSVSSSY GAS HQYGRPPAAT	GFSFDDYA ITYNGGST ARDATYCGGDCYLDY	1
ALPIKH EDR YSIDSGGIHRGV	TFTLSTSA ISGSGGST AKDWSQYYYHGSADNTRDY	4
ALPKQY KDS 	GFTFSHAW LKRKSEGGTT TTRSDYYDTSDYSFFDR	0
QEINNY DAS QQYRRFPPA	GFTFGSFA ISAGGANI VKYDSSGFDYARGGRE	1
SSNIGTNT SNN ATWDDSLDGWXX	GFTFSDYY ISFSFSLT ARALRYCSTNSCPESYYSYYGMDV	0
NTGSKS FDS QVWDSSCDCWV	GFIFDTNA ISDTGIST AKRSTYYLDRNGPNDAFDI	0
SSNIGSNT SNN ATWDDSLDGWXX	GFTFSDYY ISFSFSLT ARALRSCSSNSCPESYYYYYGMDV	0
NIASKS DDS QVWDSSGDPHVV	GFTFDSYW INLDGSEK ARAYDTTGYYNNWDIFDI	0
SGSFGTNY DNN QSYEGSNWVX	GYSITNGFY IFHTGTT NLRAFSGFDSY	2
QSLVYGDGNTY LAS MQGTHWPYT	GYNFTGSW IDPDDSYT ARLAHGTLDY	1
SSNIGSNT SNS ATWDDSLDGWXX	GFTFSDYY ISFSFGLT ARALRKCSSNSCPESYYYYYGMDV	2
ALPRQY KDS 	GGTFSTYS IIPVSGTT ARESWGDYYFEY	5
QSVSSL GAS QQWYT	GDSFSDYY VYHDGST ARGVLGELTAIHFDY	0
ASLLHSNGYNY LAS MQALQTPYT	GYRFTDYY MNPNSGAINSGT VREDVLDSYFDY	2
QSVSNNY SAS HQYGSSPQT	GGSIRMTTHY ISYSGST ARAYGVLRYFDWQPSNYYFDF	0
QSIGAW KAS QQYIRYPWT	GGSISSYL NSDSGNT ARADYDVEGYFGMDV	0
QDISNS DAS QQVWA	GFTFNIYN ITPNSNYI ARALTTMTTTDS	1
QSIGSY AAS QQSFNIFPLT	GYTFTNYD ITAYNGNT ARNLAIAAAGSSRFDY	0
QSVGTD GAS QQYNHWLGT	GGIFRNYA IIAIFGTT AGESGYSNGYEAH	5
QSIAGY DAS QQRSSWPLTX	GFTFSDYD ISDRGTKT AKGSLRDVFDI	1
ESISKY AAS QQSYSSPLT	GGIFRSYS VLPFFGTP ATGEYQLRSPLDI	6
QTISSRN AAS QQYGTSPLTX	GGIFNSHS IVAIFGTT ARGGGYHYSGSESYLTN	5
TGAVTSGYF STT 	GFTFDDYS ISWDGGNR TKDISSSWYGTQYSSGLYGMDV	4
NIGRRS DDS QVWDSGNDQGV	GFTLDDYT SNWDGEIT ARGRYYLDNTGYYPSFES	2
TSNIGENF RNH ATWDDSLSAVL	GFPFSGYG IWHDESRK ARASPYGDYYSIDDV	1
SSNIGNNF KNN AAWDDSLSGVXX	GFSLSSYG IWYDGSKK ARASPYGDYYAIEDV	0
QGISNY KAS QQYDDFPYT	GFRFDDYA ISWNSYSR AKDTKSQSPYASMDLLEGDGMDV	1
SSNIGENF RNH AAWDDSLSGVXX	GFPFSGYG IWYDGSKK ARASPYGDYYSIEDV	3
SSNIGENY QNN AAWDDSLSGVVX	GFSVSGYG MWFDGTKE ARASPYGDYYAIEDD	6
TGAVTSDNY STS LLSYGGPWV	EFTFRYYA ISDDGNTK ARYYSYFDY	2
SSNIGSNF RNN ATWDDSLSGPVV	GFTFSTYS ISDSTGTV ARGGTRYYYGSGSHMDV	1
QDLSNS DAS QQYVF	GFTFSSYT IFTXSRYI ARDRGSTTADY	1
QDISTF DAS QQYDNFLS	GFTFDDYA ISGDGRMT VKDHWTDN	0
EDINTY DAS QQRSNWPLT	GFIFSNFP FGDSATKT AKGSAKFKSQQFLARSGYTQRSHFDF	0
SSNIGSYT SDT ATWDDSLNGAI	GFSFNSNG ISHDGSHK AKDLTLRFFDWPNYYGMDV	0
QSLLYSNGYNY LGS MQVLQTAPYT	GFTFSSYE ITSSGNTI AREKERYPTFDS	1
QSISRD GAS QQYNNWPPIT	GFTLTNYA ISATGGST AKDAIAGRVWLQGAFDS	4
QDLSNS DAS QQYVF	GFTFSSYT IFXXSRYI ARDRGSTTADY	1
QSLLHSNGYNY LGS MQALQTPRT	GGSIRSYY MSYSGNA GRQFYDSHYYYYYNMDV	1
QSVTSNY GAS QQYGNSPFN	GFSFSSYA VSTSGGDT GKSIENMVRGLLITSFAYYFAVDV	4
QDISNY DAS QQYDNVPIT	GFIFSNYE ISSGGRDI ARGSSSSWHGGLWAHWFDP	1
QNIRTF AAS QSSYTTPS	GDSVSSAGHY IHHRGST ARLWAGIVGPTPPFFDY	5
GSNIRINY RSN AAWDDILSGHV	GFIFGDYA IGSKTHGGTT ARDPGGFYDSYGFYYLGAFDI	1
SSNIENNY DNN QTWDDNLSAVI	GFTFGNYA VTGSATRI AKEPHSGSWYPYFDY	1
SSNIGSNT SNN AAWDDSLNGWVX	GFIFRDYW IKQDGSEI VQLRMY	1
QDISNY DAS QQYDNLPFG	GFTFSNYN ISLSSSFI ARGGSGGHNYYYALDV	1
QSVSSNY GAS QQYANSPFT	GFSFSSYA ISTSGGIT GKSIENMVRGLLITSFAYYFAMDV	6
QSVTNNY GAS QQYGRSSNT	GFTVDSHD LTSTGDT ARNYYNRDLGYDGMDV	1
QSVSSN GAS QQYNNWPPIT	GFTFSKYA ISGSGIST AKDAISGQIWLQGTFDY	6
QSVGSN GAS QQYHNWPPIT	GFTFSSYA ISDSGYST AKDGISRQVWLQGTFDS	1
SXGLKR YDX XVWDISGDHVVX	GYSLSNGYY LYHSGRT TRIYMVRDLEIYYFDS	6
SIGLKR YDS QVWDISGEHVVX	GYSISNGYY IYYSGST TRIYMVRDLEIYYFDS	6
SIGLKR YDS QVWDVSGDHLV	GYSISSFYY IYHSGNT ARIYMVRDLEIYYFDS	6
ALPKHY KDS QSADDSGTYV	GLTFSNVW IKSNTDGGAT AAEDFGDYYFDY	0
NFNIEHNY DNN GTWDSSLSVYV	GFTFSDYN INGRSRYI ARHRPGGDYYYYGMDV	0
SIGLKR YDS QVWDVSGDHLV	GYSISNGYY IYHSGST ARIYMVRDLEIYYFDS	3
QSLVYSDGNTY QVS MQGTHWPYT	GYNFTNYW IDPSDSYT ARLLYGSVDF	0
SIGLKR YDS QVWDVSGDHLV	GYSISNGYY IYHSGST ARIYMVRDLEIYYFDS	6
SIGLKR YDS QVWDISGDHVVX	GYSISNGYY IYHSGST TRIYMVRDLEIYYFDS	1
GAIIASNQ EGD QSYDTGLWV	GFTFSDYY INSRSNYR AAGSGSYSYHGLDV	2
SNDVGSYNR EVG ISYTSSSTWXXX	GLIFTKSG IWYDGSKK AKDWGLKAFDV	1
NIRVKN RDS QVRDSGTWXX	GFTFNTYA ISHDGSNT SREYYDTLTGPEDYDYGMDV	4
RSLVYNDENTY KVS MQATYWPYT	GFTFSSSW IKQDGSEK ARDPFVGRYGAFDI	1
NIGTKN RDD QVWDSNTAL	GGSISSSTDY IYYSGST ARFLRGDFVSWFDP	2
QSVSTY DAS QQRSNWPPIT	GFTFSGYA ISGSGGST AKDRVVPTALHGYLDS	3
GAIIASNY EGN QSYDTGLWV	GFSFSDYY IDSRSTYR AAGSRSYSYHGLDV	2
NIRVKN RDN QVWDSSSWVX	EFTFSNYA ISNDGGKR AREYYDTLTGPVDYDYGMDV	1
GAIIASNF EGN QSYDTGLWV	GFTFSDYY INSRSSYR AAGSGSYNYHGLDV	3
QSVSSY EAS QQRGNWPIT	GFNFGDYA IRNLAYGEST TRERVDLDAFDM	1
SSNIENNY RNN AAWDDSLSGVV	GFTFNAYG ISFDGTNK AKEYAIRYADAFDF	0
GAIIASNY EGD QSYDTGLWV	GFSFSDYY IDSRSTYR AAGAGSYSYHGLDV	1
GAIIASIY EGD QSYDTGLWV	GFSFSDYY IDSRSTYR AAGSGSYSYHGLDV	1
SGIIAGSF KND QSYDTGFWV	GFTLSDYY INTKSSYR AAGSGTYDYYGLDV	0
GAIIANIY EGT QSYDTGLWV	GFSFSDYY IDSRSTFA AAGSGGYSYHGLDV	2
GAIIASNF EGD QSYDTGLWV	GFTFSDYY IDSRSTYR AAGSGSYNYHGLDV	0
NIRVKN RDS QVRDSGTWXX	GFTFKTYA ISHDGSNK SREYYDILTGPEDYDYGMDV	2
SSNIGAAYD GNT QSYDNSLNGFYV	GGSISNYY IYDDSGST ARGGVDPYTSSWYYFDY	1
GSDIGANSY DVS SSYRITTTLVV	GFAFDDYA CSWNCGTK AKGYGSGNSYPLAPTLDY	1
GSDIGDNSY DVS SAYRSSSTLVV	GFSFDDYA CSWNSATK AKGYGSGNHYPLAPTLDY	0
GSDIGGHSY DVS SSYRSSSTLVI	GFTFDDYA CSWNSGVK AKGYGSGNHYPLAPTLDY	2
GSDIGDNSY DVS SAYRSSSTLVV	GFSFDDYA CSWNSATK AKGYGSGNHYPLAPTLDY	0
SSDIGGYSY DVT SSYRVSNTLVV	GFSFDDYA LSWNSGTI AKGYGSGSSYPLAPMLDY	1
SSDIGGYNY DVS SSYRISSTLVV	GFNFDDYA LSWNSGSI AKGYGSGSSYPLAPTLDY	0
GSDIGGNSY DVS CSYRSSTTLVV	GFTFDDYA CSWNSGTK AKGYGSGNSYPLAPTLDY	0
GSDIGDNSY DVS CSYRRSSTLVV	GFTFDDYA CTWNSATK AKGYGSGNSYPLAPTLDY	0
SSNIGSNA STN EAWDDSLKEV	GFTFSNYG ISYGGSET AKTTVTTDFYYYYGMDV	0
QTINKF SAS QHGHIGPST	GFIFNDYG INWIGSAT ARESGSDVATAMDYYYYYYMDV	1
GSDIGDNSY DVS SAYRSSSTLVV	GFSFDDYA CSWNSATK AKGYGSGNHYHLAPTLDY	0
GSDIGGNSY DVS SSYRSSSTLVV	GFTFDDYA CSWNSGTK AKGYGSGNYYPLAPTLDY	1
GSDVGGNSY DVS SSYRTSSTLVV	GFTFDDYA ISWNSGII AKGYGSGNYYPLAPTLDY	0
QSILYTPNKKSS WAS QQYYGTLST	GGSVSSSSYH IYYTGTT ARLYNYAYGDP	1
SSNIGSNT STN AAWDDSLKEV	GFTFSSYG ISYVGSDK AKATVTTDFSYYYGMDV	0
GSDIGDNSY DVS SAYRSSSTLVV	GFSFDDYA CSWNSATK AKGYGSGNHYPLAPTLDY	0
TGAVTSGYY STG LLYYGGGWV	GGSIRSYY IYYTGST AGRSATVLADSDY	0
TGAVTSGYY STS LLYYGGGWV	GGSIRSYY IYYTGST AGRSATVLADSDY	0
SSDVGTYNY DVS CSYAGSYTFVV	GGSISGYH INYSGST VRHEWAPRGLDAFDF	1
QSVGSY DTS LQRDNWPLT	GGSITRSGFY LQSGWGT ARLAGAATSIEDITHYNHYGMDV	0
QNIDTF GTS QQSYILPRT	GGSISSTEYY IYYSGGT ARDRKPAMECIGSGCSFVRLGFDP	1
SSDVGTYNY DVG CSYAGSYTFVV	GGSIRGYH INYSGST VRHEWAPRGLDAFDF	2
QSISNN SSS QQSYSPFLT	GGSFSGYY ITHSGGT ARGPAYDSNAYFLYYFDY	0
QDINIY DAS QRYDSLRVT	GFTFDDFA ISWNGGTT ARAPARGLGMDV	2
QDISNS GAS QQYDHLPYT	GFTFRNYE ISSSGSTL ARGNQEGVGELSSQGVFDN	0
QSIDSFH GAS QQYGNSQYT	NYSLTSGYY VFHTGTS ASRWASTKYFNF	0
NIGSKH DDK QVWDSSNDHRV	GFSFSYYW IKPDGHEK AREGLGDYYESNYYFDY	1
ALPRQY KDR QSSDSGKSRV	GFTFSDYY ISSGPGDT ARDDFGDYVSDS	5
SSNIGTNY KND AAWDDSLSGWXX	GFTFNTHS ISRSSTYK ARDGANNSGFD	5
RSDVGGYNY DVK 	GFTFSTYA ISGSGGST AKEGGDFWSGYYANWFDP	6
SIGLKR YDS QVWDVSGDHTV	GYSISSAYY IYHSGST ARIYMVRDLEIYYFDS	0
QSISNN SSS QQSYSPFLT	GGSFSGYY ITHSGGT ARGPAYDSNAYFLYYFDY	0
